WWWWWWWWWWWWW
W           W
W RRRRRRRRWWW
W           W
W RRWWWRR   W
W W   R     W
W WWWWWWW   W
W    R      W
W    R      W
W RRR WWWW  W
W R   W W   W
W R   W     W
WWWWWWWWWWWWW
